********************/
*------------------*/
*-*******-****-*-*-*/
*-------*-*----*-*-*/
*-*****---*----*-*-*/
*-*****---*------*-*/
*---------*--------*/
*-----*--------*---*/
*---*-----*----*---*/
*---*-----*----*---*/
*---*******----*---*/
*------------------*/
*--**************--*/
*------------------*/
********************/
